1111111111111111111111111111111
11111C0E0P000000000000000011111
1100000000001010000000000C00011
1000000000000000000000000000001
100000000000C000000000C00000011
1100000101011111100000000010111
1111100000000000000111110000001
10C00000000C000000000000000C011
1110000011111110000000000000011
1111111111111111111111111111111
