1111111111
100000PCE1
1100000001

1000000001
1111111111
