11111111111111111
11111E11111111111
1111111111P00C001
11111111111111111
