111111111111111111111
100000000EC000000001111
1000000000P0000000111
111111111111111111111
