01111110
100E0001
100C0001
100P0001
01111110
