11111111111
10E01100001
1C100100101
10100P00101
10100C001C1
11111111111
