111111111111111111111111111111111111111111111111111111111111111111111111111111111111111111111111111111111111111111111111111
1P1111111111111111111111111111111111111111111111111111111111111111111111111111111111111111111111111111111111111111111111111
10C111111111111111111111111111111111111111111111111111111111111111111111111111111111111111111111111111111111111111111111111
1E1111111111111111111111111111111111111111111111111111111111111111111111111111111111111111111111111111111111111111111111111
111111111111111111111111111111111111111111111111111111111111111111111111111111111111111111111111111111111111111111111111111
